||||||||||
|OOOO|OOO|
|OO|OOO|O|
|||O|O|OOE
|OOO|O||O|
|O|O|O|OO|
||OO|O||O|
|O||OO|OO|
|OOOOO|OO|
||||||||||